gh alerts	ericwb/gh-alerts	
gh branch	mislav/gh-branch	
gh clean-branches	davidraviv/gh-clean-branches	
gh clone-org	matt-bartel/gh-clone-org	
gh contribute	vilmibm/gh-contribute	
gh default-branch	daido1976/gh-default-branch	
gh gitignore	tst32/gh-gitignore	
gh graph	kawarimidoll/gh-graph	
gh label	heaths/gh-label	
gh markdown-preview	yusukebe/gh-markdown-preview	
gh notify	meiji163/gh-notify	
gh orgstats	VildMedPap/gh-orgstats	
gh prs	dlvhdr/gh-prs	
gh repo-topic	mislav/gh-repo-topic	
gh screensaver	vilmibm/gh-screensaver	
gh todo	yuler/gh-todo	
gh user-stars	korosuke613/gh-user-stars	
gh user-status	vilmibm/gh-user-status	
gh userfetch	sheepla/gh-userfetch	
gh vulns	hexium310/gh-vulns	
